{
  "bossSpawnPoint": {
    "x": 54,
    "y": 54
  },
  "predefinedTrajectories": {

    "5": [
      { "points": [{ "x": 100, "y": 42 },
        { "x": 66, "y": 39 },
        { "x": 30, "y": 43 },
        { "x": -4, "y": 44 }
      ]},
      { "points": [ { "x": 104, "y": 57 },
        { "x": 73, "y": 51 },
        { "x": 42, "y": 49 },
        { "x": -7, "y": 38 }
      ]},
      { "points": [{ "x": 39, "y": -9 },
        { "x": 48, "y": 31 },
        { "x": 46, "y": 70 },
        { "x": 34, "y": 97 }
      ]},
      { "points": [{ "x": 46, "y": -8 },
        { "x": 44, "y": 23 },
        { "x": 50, "y": 60 },
        { "x": 36, "y": 98 }
      ]}
    ],


    "3": [
      { "points": [{ "x": 91, "y": 30 }, { "x": 3, "y": 30 }]},
      { "points": [{ "x": 100, "y": 39 },{ "x": -5, "y": 39 }]},
      { "points": [{ "x": 106, "y": 50 },{ "x": -11, "y": 50 }]},
      { "points": [{ "x": 106, "y": 56 },{ "x": -5, "y": 56 }]},
      { "points": [{ "x": 100, "y": 61 },{ "x": -3, "y": 61 }]},
      { "points": [{ "x": 106, "y": 45 },{ "x": -10, "y": 45 }]}
    ],

    "-10": [
      { "points": [{ "x": 81, "y": 30 }, { "x": 13, "y": 30 }]},
      { "points": [{ "x": 90, "y": 39 },{ "x": 5, "y": 39 }]},
      { "points": [{ "x": 96, "y": 50 },{ "x": 1, "y": 50 }]},
      { "points": [{ "x": 96, "y": 56 },{ "x": 5, "y": 56 }]},
      { "points": [{ "x": 90, "y": 61 },{ "x": 7, "y": 61 }]},
      { "points": [{ "x": 96, "y": 45 },{ "x": 0, "y": 45 }]}
    ],

    "16": [
      { "points": [{ "x": 94, "y": 0 }, { "x": 0, "y": 94 }]}
    ],

    "8": [
      { "points": [{ "x": 90, "y": 34 }, { "x": 62, "y": 38 }, { "x": 27, "y": 42 },  { "x": -5, "y": 45 } ]}
    ],

    "0": [
      { "points": [{ "x": 85, "y": 35 },
        { "x": 81, "y": 35 },
        { "x": 77, "y": 36 },
        { "x": 74, "y": 36 },
        { "x": 72, "y": 39 },
        { "x": 69, "y": 41 },
        { "x": 65, "y": 43 },
        { "x": 62, "y": 44 },
        { "x": 58, "y": 45 },
        { "x": 54, "y": 44 },
        { "x": 50, "y": 42 },
        { "x": 46, "y": 40 },
        { "x": 42, "y": 41 },
        { "x": 38, "y": 43 },
        { "x": 34, "y": 46 },
        { "x": 30, "y": 47 },
        { "x": 27, "y": 48 },
        { "x": 23, "y": 46 },
        { "x": 20, "y": 44 },
        { "x": 16, "y": 43 },
        { "x": 12, "y": 44 },
        { "x": 8, "y": 46 },
        { "x": 6, "y": 48 },
        { "x": 2, "y": 51 }
      ]},
      { "points": [{ "x": 6, "y": 54 },
        { "x": 8, "y": 51 },
        { "x": 10, "y": 49 },
        { "x": 15, "y": 49 },
        { "x": 20, "y": 50 },
        { "x": 24, "y": 50 },
        { "x": 27, "y": 49 },
        { "x": 30, "y": 47 },
        { "x": 32, "y": 45 },
        { "x": 37, "y": 44 },
        { "x": 42, "y": 42 },
        { "x": 47, "y": 43 },
        { "x": 52, "y": 44 },
        { "x": 56, "y": 44 },
        { "x": 62, "y": 43 },
        { "x": 63, "y": 40 },
        { "x": 68, "y": 38 },
        { "x": 74, "y": 38 },
        { "x": 78, "y": 39 },
        { "x": 83, "y": 37 },
        { "x": 85, "y": 35 }
      ]},
      { "points": [{ "x": 81, "y": 31 },
        { "x": 79, "y": 36 },
        { "x": 76, "y": 39 },
        { "x": 71, "y": 40 },
        { "x": 68, "y": 41 },
        { "x": 67, "y": 43 },
        { "x": 67, "y": 47 },
        { "x": 67, "y": 50 },
        { "x": 64, "y": 53 },
        { "x": 61, "y": 55 },
        { "x": 56, "y": 58 },
        { "x": 53, "y": 58 },
        { "x": 51, "y": 61 },
        { "x": 49, "y": 66 },
        { "x": 49, "y": 70 },
        { "x": 48, "y": 74 },
        { "x": 44, "y": 77 },
        { "x": 41, "y": 78 },
        { "x": 37, "y": 81 },
        { "x": 34, "y": 84 },
        { "x": 35, "y": 86 }
      ]},
      { "points": [{ "x": 41, "y": 3 },
        { "x": 41, "y": 6 },
        { "x": 42, "y": 10 },
        { "x": 44, "y": 12 },
        { "x": 47, "y": 14 },
        { "x": 49, "y": 17 },
        { "x": 48, "y": 21 },
        { "x": 48, "y": 24 },
        { "x": 50, "y": 28 },
        { "x": 53, "y": 32 },
        { "x": 55, "y": 36 },
        { "x": 58, "y": 40 },
        { "x": 57, "y": 46 },
        { "x": 56, "y": 51 },
        { "x": 58, "y": 57 },
        { "x": 61, "y": 63 },
        { "x": 63, "y": 67 },
        { "x": 66, "y": 70 },
        { "x": 66, "y": 74 },
        { "x": 66, "y": 81 }
      ]}
    ],

    "11": [
      { "points": [{ "x": 86, "y": 35 },
        { "x": 72, "y": 36 },
        { "x": 63, "y": 43 },
        { "x": 50, "y": 40 },
        { "x": 41, "y": 46 },
        { "x": 30, "y": 43 },
        { "x": 19, "y": 47 },
        { "x": 9, "y": 44 },
        { "x": 1, "y": 49 }
      ]},
      { "points": [{ "x": 4, "y": 52 },
        { "x": 11, "y": 50 },
        { "x": 20, "y": 52 },
        { "x": 32, "y": 49 },
        { "x": 47, "y": 51 },
        { "x": 57, "y": 46 },
        { "x": 69, "y": 45 },
        { "x": 78, "y": 39 },
        { "x": 86, "y": 35 }
      ]},
      { "points": [{ "x": 88, "y": 59 },
        { "x": 71, "y": 55 },
        { "x": 59, "y": 54 },
        { "x": 44, "y": 46 },
        { "x": 32, "y": 45 },
        { "x": 23, "y": 40 },
        { "x": 13, "y": 42 },
        { "x": 6, "y": 39 }
      ]},
      { "points": [{ "x": 89, "y": 59 },
        { "x": 81, "y": 61 },
        { "x": 70, "y": 63 },
        { "x": 63, "y": 71 },
        { "x": 52, "y": 73 },
        { "x": 43, "y": 81 },
        { "x": 33, "y": 84 }
      ]}
      ,
      { "points": [
        { "x": 83, "y": 33 },
        { "x": 79, "y": 41 },
        { "x": 70, "y": 43 },
        { "x": 65, "y": 53 },
        { "x": 54, "y": 59 },
        { "x": 54, "y": 70 },
        { "x": 39, "y": 77 },
        { "x": 35, "y": 87 }
      ]},
      { "points": [
        { "x": 14, "y": 45 },
        { "x": 23, "y": 43 },
        { "x": 32, "y": 49 },
        { "x": 40, "y": 44 },
        { "x": 50, "y": 46 },
        { "x": 55, "y": 39 },
        { "x": 66, "y": 39 },
        { "x": 74, "y": 35 },
        { "x": 85, "y": 35 }
      ]},
      { "points": [
        { "x": 2, "y": 51 },
        { "x": 11, "y": 45 },
        { "x": 20, "y": 51 },
        { "x": 31, "y": 46 },
        { "x": 42, "y": 49 },
        { "x": 51, "y": 42 },
        { "x": 63, "y": 37 },
        { "x": 76, "y": 40 },
        { "x": 84, "y": 34 }
      ]},
      { "points": [
        { "x": 38, "y": 6 },
        { "x": 41, "y": 16 },
        { "x": 49, "y": 24 },
        { "x": 51, "y": 34 },
        { "x": 62, "y": 46 },
        { "x": 60, "y": 60 },
        { "x": 69, "y": 68 },
        { "x": 68, "y": 80 }
      ]},
      { "points": [
        { "x": 87, "y": 60 },
        { "x": 73, "y": 56 },
        { "x": 61, "y": 55 },
        { "x": 47, "y": 49 },
        { "x": 33, "y": 51 },
        { "x": 17, "y": 43 },
        { "x": 3, "y": 43 }
      ]},
      { "points": [
        { "x": 61, "y": 86 },
        { "x": 67, "y": 76 },
        { "x": 65, "y": 66 },
        { "x": 75, "y": 58 },
        { "x": 70, "y": 46 },
        { "x": 65, "y": 30 },
        { "x": 52, "y": 22 },
        { "x": 38, "y": 4 }
      ]}

    ]


  }
}

