{
  "bossSpawnPoint": {
    "x": 54,
    "y": 54
  },
  "predefinedTrajectories": {
    "5": [
      { "points": [{ "x": 101, "y": 41 },
        { "x": 58, "y": 47 },
        { "x": 22, "y": 45 },
        { "x": -11, "y": 46 }
      ]},
      { "points": [{ "x": 106, "y": 51 },
        { "x": 68, "y": 50 },
        { "x": 32, "y": 43 },
        { "x": -11, "y": 51 }
      ]},
      { "points": [{ "x": 104, "y": 59 },
        { "x": 50, "y": 51 },
        { "x": 12, "y": 49 },
        { "x": -11, "y": 41 }
      ]},
      { "points": [{ "x": 96, "y": 34 },
        { "x": 62, "y": 42 },
        { "x": 21, "y": 47 },
        { "x": -8, "y": 55 }
      ]}

    ],

    "3": [
      { "points": [{ "x": 91, "y": 30 }, { "x": 3, "y": 30 }]},
      { "points": [{ "x": 100, "y": 39 },{ "x": -5, "y": 39 }]},
      { "points": [{ "x": 106, "y": 50 },{ "x": -11, "y": 50 }]},
      { "points": [{ "x": 106, "y": 56 },{ "x": -5, "y": 56 }]},
      { "points": [{ "x": 100, "y": 61 },{ "x": -3, "y": 61 }]},
      { "points": [{ "x": 106, "y": 45 },{ "x": -10, "y": 45 }]}
    ],

    "-10": [
      { "points": [{ "x": 81, "y": 30 }, { "x": 13, "y": 30 }]},
      { "points": [{ "x": 90, "y": 39 },{ "x": 5, "y": 39 }]},
      { "points": [{ "x": 96, "y": 50 },{ "x": 1, "y": 50 }]},
      { "points": [{ "x": 96, "y": 56 },{ "x": 5, "y": 56 }]},
      { "points": [{ "x": 90, "y": 61 },{ "x": 7, "y": 61 }]},
      { "points": [{ "x": 96, "y": 45 },{ "x": 0, "y": 45 }]}
    ],

    "16": [
      { "points": [{ "x": 94, "y": 0 }, { "x": 0, "y": 94 }]}
    ],


    "8": [
      { "points": [{ "x": 98, "y": 44 }, { "x": 63, "y": 44 }, { "x": 30, "y": 44 },  { "x": -4, "y": 44 } ]}
    ],

    "0": [
      { "points": [{ "x": 94, "y": 44 },
        { "x": 89, "y": 43 },
        { "x": 84, "y": 43 },
        { "x": 80, "y": 45 },
        { "x": 77, "y": 48 },
        { "x": 74, "y": 50 },
        { "x": 70, "y": 52 },
        { "x": 65, "y": 50 },
        { "x": 60, "y": 49 },
        { "x": 55, "y": 48 },
        { "x": 50, "y": 50 },
        { "x": 44, "y": 51 },
        { "x": 39, "y": 53 },
        { "x": 33, "y": 53 },
        { "x": 29, "y": 51 },
        { "x": 24, "y": 49 },
        { "x": 19, "y": 48 },
        { "x": 15, "y": 48 },
        { "x": 11, "y": 47 },
        { "x": 7, "y": 44 },
        { "x": 3, "y": 41 }
      ]},
      { "points": [{ "x": 8, "y": 37 },
        { "x": 13, "y": 40 },
        { "x": 18, "y": 43 },
        { "x": 22, "y": 44 },
        { "x": 26, "y": 43 },
        { "x": 32, "y": 46 },
        { "x": 37, "y": 48 },
        { "x": 43, "y": 51 },
        { "x": 47, "y": 51 },
        { "x": 52, "y": 51 },
        { "x": 59, "y": 53 },
        { "x": 64, "y": 55 },
        { "x": 70, "y": 58 },
        { "x": 76, "y": 60 },
        { "x": 82, "y": 60 },
        { "x": 90, "y": 59 }
      ]},
      { "points": [{ "x": 79, "y": 29 },
        { "x": 79, "y": 34 },
        { "x": 78, "y": 38 },
        { "x": 76, "y": 41 },
        { "x": 73, "y": 44 },
        { "x": 70, "y": 48 },
        { "x": 68, "y": 51 },
        { "x": 68, "y": 57 },
        { "x": 67, "y": 62 },
        { "x": 63, "y": 67 },
        { "x": 59, "y": 71 },
        { "x": 57, "y": 76 },
        { "x": 56, "y": 85 },
        { "x": 57, "y": 91 }
      ]},
      { "points": [{ "x": 90, "y": 59 },
        { "x": 86, "y": 57 },
        { "x": 82, "y": 55 },
        { "x": 77, "y": 55 },
        { "x": 72, "y": 55 },
        { "x": 67, "y": 56 },
        { "x": 62, "y": 57 },
        { "x": 55, "y": 57 },
        { "x": 49, "y": 53 },
        { "x": 43, "y": 49 },
        { "x": 37, "y": 50 },
        { "x": 31, "y": 53 },
        { "x": 24, "y": 53 },
        { "x": 17, "y": 49 },
        { "x": 10, "y": 45 },
        { "x": 4, "y": 40 }
      ]}
    ],


    "11": [
      { "points": [{ "x": 78, "y": 28 },
        { "x": 74, "y": 35 },
        { "x": 77, "y": 44 },
        { "x": 70, "y": 51 },
        { "x": 71, "y": 61 },
        { "x": 63, "y": 68 },
        { "x": 63, "y": 76 },
        { "x": 57, "y": 90 }
      ]},
      { "points": [{ "x": 96, "y": 46 },
        { "x": 79, "y": 44 },
        { "x": 68, "y": 51 },
        { "x": 56, "y": 47 },
        { "x": 45, "y": 53 },
        { "x": 32, "y": 50 },
        { "x": 23, "y": 53 },
        { "x": 11, "y": 48 },
        { "x": 1, "y": 44 }
      ]},
      { "points": [{ "x": 89, "y": 39 },
        { "x": 84, "y": 38 },
        { "x": 75, "y": 42 },
        { "x": 65, "y": 39 },
        { "x": 54, "y": 41 },
        { "x": 45, "y": 38 },
        { "x": 35, "y": 42 },
        { "x": 25, "y": 39 },
        { "x": 17, "y": 42 },
        { "x": 6, "y": 38 }
      ]},
      { "points": [
        { "x": 79, "y": 28 },
        { "x": 78, "y": 37 },
        { "x": 73, "y": 40 },
        { "x": 70, "y": 45 },
        { "x": 60, "y": 47 },
        { "x": 53, "y": 53 },
        { "x": 42, "y": 52 },
        { "x": 33, "y": 55 },
        { "x": 24, "y": 51 },
        { "x": 13, "y": 50 },
        { "x": 1, "y": 43 }
      ]},
      { "points": [
        { "x": 89, "y": 39 },
        { "x": 77, "y": 39 },
        { "x": 66, "y": 38 },
        { "x": 56, "y": 33 },
        { "x": 48, "y": 36 },
        { "x": 36, "y": 39 },
        { "x": 26, "y": 46 },
        { "x": 11, "y": 43 },
        { "x": 0, "y": 43 }
      ]},
      { "points": [
        { "x": 94, "y": 43 },
        { "x": 78, "y": 42 },
        { "x": 68, "y": 46 },
        { "x": 51, "y": 43 },
        { "x": 38, "y": 49 },
        { "x": 21, "y": 48 },
        { "x": 5, "y": 39 }
      ]},
      { "points": [
        { "x": 91, "y": 57 },
        { "x": 76, "y": 49 },
        { "x": 62, "y": 47 },
        { "x": 47, "y": 41 },
        { "x": 34, "y": 44 },
        { "x": 22, "y": 39 },
        { "x": 11, "y": 43 },
        { "x": 1, "y": 44 }
      ]},
      { "points": [
        { "x": 82, "y": 67 },
        { "x": 71, "y": 61 },
        { "x": 60, "y": 61 },
        { "x": 44, "y": 50 },
        { "x": 28, "y": 51 },
        { "x": 14, "y": 43 },
        { "x": 1, "y": 43 }
      ]},
      { "points": [
        { "x": 88, "y": 60 },
        { "x": 78, "y": 55 },
        { "x": 66, "y": 52 },
        { "x": 51, "y": 43 },
        { "x": 40, "y": 44 },
        { "x": 24, "y": 51 },
        { "x": 1, "y": 43 }
      ]}
    ]

  }

}

